2048 1280
G1 G2 G1 G2 G1 G1 G4 G1 G1 G1 G1 G1 G1 G1 G1 G1 G1 G1 G1 G1 G1 G1 G1 G1 G1 G1 G1 G1 G1 G1 G1 G1
G1 G3 G2 H4 G3 G3 G1 G1 G1 G1 G1 G1 G1 G1 G1 G1 G1 G1 G1 G1 G1 G1 G1 G1 G1 G1 G1 G1 G1 G1 G1 G1
G2 G2 G2 G1 G4 G1 G2 G1 G1 G1 G1 G1 G1 G1 G1 G1 G1 G1 G1 G1 G1 G1 G1 G1 G1 G1 G1 G1 G1 G1 G1 G1
G1 G2 G1 G1 G1 G4 G1 G1 G1 G1 G1 G1 G1 G1 G1 G1 G1 G1 G1 G1 G1 G1 G1 G1 G1 G1 G1 G1 G1 G1 G1 G1
G2 H1 G3 G2 G1 G2 G2 G1 G1 G1 G1 G1 G1 G1 G1 G1 G1 G1 G1 G1 G1 G1 G1 G1 G1 G1 G1 G1 G1 G1 G1 G1
G1 G1 H2 G1 G4 G1 H3 H3 G1 G1 H1 H1 H1 H1 H1 H1 H1 H1 H1 H1 H1 H1 G1 G1 G1 G1 G1 G1 G1 G1 G1 G1
G3 BS G2 G3 G1 G1 H3 H3 H3 G1 H1 G1 G1 G1 G1 G1 G1 G1 G1 G1 G1 G1 G1 G1 G1 G1 G1 G1 G1 G1 RS G1
G4 G1 G4 G1 G1 G1 G1 G1 H3 G1 H1 G1 G1 G1 G1 G1 G1 G1 G1 G1 G1 G1 G1 G1 G1 G1 G1 G1 G1 G1 G1 G1
G1 BS G1 G1 G1 G1 G1 G1 G1 G1 H1 G1 G1 G1 G1 G1 G1 G1 G1 G1 G1 H1 G1 G1 G1 G1 G1 G1 G1 G1 RS G1
G1 G1 G1 G1 G1 G1 G1 G1 G1 G1 H1 G1 G1 G1 G1 H1 H1 G1 G1 G1 G1 H1 G1 G1 G1 G1 G1 G1 G1 G1 G1 G1
G1 G1 G1 G1 G1 G1 G1 G1 G1 G1 H1 G1 G1 G1 G1 H1 H1 G1 G1 G1 G1 H1 G1 G1 G1 G1 G1 G1 G1 G1 G1 G1
G1 BS G1 G1 G1 G1 G1 G1 G1 G1 H1 G1 G1 G1 G1 G1 G1 G1 G1 G1 G1 H1 G1 G1 G1 G1 G1 G1 G1 G1 RS G1
G1 G1 G1 G1 G1 G1 G1 G1 G1 G1 G1 G1 G1 G1 G1 G1 G1 G1 G1 G1 G1 H1 G1 G1 G1 G1 G1 G1 G1 G1 G1 G1
G1 BS G1 G1 G1 G1 G1 G1 G1 G1 G1 G1 G1 G1 G1 G1 G1 G1 G1 G1 G1 H1 G1 G1 G1 G1 G1 G1 G1 G1 RS G1
G1 G1 G1 G1 G1 G1 G1 G1 G1 G1 H1 H1 H1 H1 H1 H1 H1 H1 H1 H1 H1 H1 G1 G1 G1 G1 G1 G1 G1 G1 G1 G1
G1 G1 G1 G1 G1 G1 G1 G1 G1 G1 G1 G1 G1 G1 G1 G1 G1 G1 G1 G1 G1 G1 G1 G1 G1 G1 G1 G1 G1 G1 G1 G1
G1 G1 G1 G1 G1 G1 G1 G1 G1 G1 G1 G1 G1 G1 G1 G1 G1 G1 G1 G1 G1 G1 G1 G1 G1 G1 G1 G1 G1 G1 G1 G1
G1 G1 G1 G1 G1 G1 G1 G1 G1 G1 G1 G1 G1 G1 G1 G1 G1 G1 G1 G1 G1 G1 G1 G1 G1 G1 G1 G1 G1 G1 G1 G1
G1 G1 G1 G1 G1 G1 G1 G1 G1 G1 G1 G1 G1 G1 G1 G1 G1 G1 G1 G1 G1 G1 G1 G1 G1 G1 G1 G1 G1 G1 G1 G1
G1 G1 G1 G1 G1 G1 G1 G1 G1 G1 G1 G1 G1 G1 G1 G1 G1 G1 G1 G1 G1 G1 G1 G1 G1 G1 G1 G1 G1 G1 G1 G1